111111111111111111111111
1P0000C00000000000000CE1
1P0000C000000000000000E1
100000C000000000000000E1
1000001000010000000000C1
100000100000000000000001
100000100000000000000001
111111111111111111111111
